45:07
 2 1 1 1 1 1 1 1 1 1 1 1 1 1 1 1 1 1 1 1 1 1 1 1 1 1 1 1 1 1 1 1 1 1 1 1 1 1 1 1 1 1 1 1 2
 163636363636363636363636363636363636363636363636363636363636363636363636363636363636363 1
 163636363636363636363636363636363636363636363636363636363636363636363636363636363636363 1
 163636363636363636363636363636363636363636363636363636363636363636363636363636363636363 1
 163636363636363636363636363636363636363636363636363636363636363636363636363636363636363 1
 163636363636363636363636363636363636363636363636363636363636363636363636363636363636363 1
 2 1 1 1 1 1 1 1 1 1 1 1 1 1 1 1 1 1 1 1 1 1 1 1 1 1 1 1 1 1 1 1 1 1 1 1 1 1 1 1 1 1 1 1 2

 1 1 1 1 1 111 111 111 111 111 111 111 111 111 111 111 111 111 111 111 111 111 111 111 1 1
 1         1                                                                             1
 1         1                                                                             1
 1           7   7   7   7   7   7   7   7   7   7   7   7   7   7   7   7   7   7   7   1
 1         1                                                                             1
 1         1                                                                             1
 1 1 1 1 1 111 111 111 111 111 111 111 111 111 111 111 111 111 111 111 111 111 111 111 1 1

                                                                                         1
                                                                                         1
                                                                                         1
                                                                                         1
                                                                                         1
                                                                                         1
                                                                                         1
