45:07
 2 1 1 1 1 1 1 1 1 1 1 1 1 1 1 1 1 1 1 1 1 1 1 1 1 1 1 1 1 1 1 1 1 1 1 1 1 1 1 1 1 1 1 1 2
 157575757575757575757575757575757575757575757575757575757575757575757575757575757575757 1
 157575757575757575757575757575757575757575757575757575757575757575757575757575757575757 1
 157575757575757575757575757575757575757575757575757575757575757575757575757575757575757 1
 157575757575757575757575757575757575757575757575757575757575757575757575757575757575757 1
 157575757575757575757575757575757575757575757575757575757575757575757575757575757575757 1
 2 1 1 1 1 1 1 1 1 1 1 1 1 1 1 1 1 1 1 1 1 1 1 1 1 1 1 1 1 1 1 1 1 1 1 1 1 1 1 1 1 1 1 1 2

 1 1 1 1 1 1 1 1 1 1 1 1 1 1 1 1 1 1 1 1 1 1 1 1 1 1 1 1 1 1 1 1 1 1 1 1 1 1 1 1 1 1 1 1 1
 1         1                                                                             1
 1         1                                                                             1
 1           1   1   1   1   1   1   1   1   1   1   1   1   1   1   1   1   1   1   1   1
 1         1                                                                             1
 1         1                                                                             1
 1 1 1 1 1 1 1 1 1 1 1 1 1 1 1 1 1 1 1 1 1 1 1 1 1 1 1 1 1 1 1 1 1 1 1 1 1 1 1 1 1 1 1 1 1

 2 1 1 1 1 1 1 1 1 1 1 1 1 1 1 1 1 1 1 1 1 1 1 1 1 1 1 1 1 1 1 1 1 1 1 1 1 1 1 1 1 1 1 1 2
 163636363636363636363636363636363636363636363636363636363636363636363636363636363636363 1
 163636363636363636363636363636363636363636363636363636363636363636363636363636363636363 1
 163636363636363636363636363636363636363636363636363636363636363636363636363636363636363 1
 163636363636363636363636363636363636363636363636363636363636363636363636363636363636363 1
 163636363636363636363636363636363636363636363636363636363636363636363636363636363636363 1
 2 1 1 1 1 1 1 1 1 1 1 1 1 1 1 1 1 1 1 1 1 1 1 1 1 1 1 1 1 1 1 1 1 1 1 1 1 1 1 1 1 1 1 1 2
