45:07
050505050505050505050505050505050505050505050505050505050505050505050505050505050505050505
050505050505050505050505050505050505050505050505050505050505050505050505050505050505050505
050505050505050505050505050505050505050505050505050505050505050505050505050505050505050505
050505050505050505050505050505050505050505050505050505050505050505050505050505050505050505
050505050505050505050505050505050505050505050505050505050505050505050505050505050505050505
050505050505050505050505050505050505050505050505050505050505050505050505050505050505050505
050505050505050505050505050505050505050505050505050505050505050505050505050505050505050505

 1 1 1 1 1 1 1 1 1 1 1 1 1 1 1 1 1 1 1 1 1 1 1 1 1 1 1 1 1 1 1 1 1 1 1 1 1 1 1 1 1 1 1 1 1
 1         1                                                                             1
 1         1                                                                             1
 1           1   1   1   1   1   1   1   1   1   1   1   1   1   1   1   1   1   1   1   1
 1         1                                                                             1
 1         1                                                                             1
 1 1 1 1 1 1 1 1 1 1 1 1 1 1 1 1 1 1 1 1 1 1 1 1 1 1 1 1 1 1 1 1 1 1 1 1 1 1 1 1 1 1 1 1 1

050505050505050505050505050505050505050505050505050505050505050505050505050505050505050505
050505050505050505050505050505050505050505050505050505050505050505050505050505050505050505
050505050505050505050505050505050505050505050505050505050505050505050505050505050505050505
050505050505050505050505050505050505050505050505050505050505050505050505050505050505050505
050505050505050505050505050505050505050505050505050505050505050505050505050505050505050505
050505050505050505050505050505050505050505050505050505050505050505050505050505050505050505
050505050505050505050505050505050505050505050505050505050505050505050505050505050505050505
